c#c#ccccJ#CCCCC%CCCC
CC$CCC%CCCCCJ#WCCCCC
CCCCCCCCCCCCCCCCCCCC
C#CCCCWCC#CCCCC#CCCC
%#PCCC#CC#JCCCC$%@C&
CCCCCCCCCCC##CCCCCCC
CJCCCCCC#CC#C$%C#CCC
CC#CCCCJCW#CCWC#CC#C
CJCCCCPC#&$WC%CCCCCC
%C&C##CCC%CCC##CJCCC
CCCC$C#CCCCC%C#CCC@C
CC%CCCCCC#CCCCCCCCCC
C$&PJCCCCCCC#C&$C%C@
CCCCCC#WC#CCCCCCCCC$
C#CC@C#CCC#CC#CCCCCC
C%P#C#CCCCCC#PCCJJC#
CCCCCCPCCCCCC#CCW#CC
CCC*CCCCC$CCP#CC#C%C
C##CCCCC#CCCC#CC#@#%
#CCCCCCC#CCCCC@CCPC%